#######################
#   # ##          O  ##
##      X             #
#       X          #  #
#####     #############
##          P      #  #
#       O          #  #
#      #              #
#######################
